{
	"width": 26,
	"height": 18,
	"scale": 25.4,
	
	"layout": [ "..............D...........",
				"..........................",
				"..........................",
				"..........................",
				"..........................",
				".........................L",
				"..........................",
				"..........................",
				"R.........................",
				"..........................",
				"..........................",
				".........................L",
				"..........................",
				"..........................",
				"..........................",
				"..........................",
				"..........................",
				"..........U.......U......." ]
}
